{
    "startingRoom":"room1",
    "defBGColor":[150,150,150],
    "rooms":{
        "room1":{
            "exit":{
                "self":{
                    "to":"room1",
                    "changeNextBy":0
                },
                "left":{
                    "to":"room4",
                    "changeNextBy":0
                },
                "right":{
                    "to":"room2",
                    "changeNextBy":0
                },
                "top":{
                    "to":"",
                    "changeNextBy":0
                },
                "bottom":{
                    "to":"",
                    "changeNextBy":0
                }
            },
            "roomstate":0,
            "data":[
                [1,1,1,1,1,1,1,1,1,1,1,1,1,1,1,1,1,1,1,1],
                [1,0,0,0,0,0,0,0,0,0,0,0,0,0,0,0,0,0,0,1],
                [1,0,0,0,0,0,0,0,0,0,0,0,0,0,0,0,0,0,0,1],
                [1,0,0,0,0,0,0,0,0,0,0,0,0,0,0,0,0,0,0,1],
                [1,0,0,1,2,1,1,1,1,1,2,1,0,0,0,0,0,0,0,1],
                [1,0,0,0,2,1,0,0,0,1,2,0,0,0,0,0,0,0,0,1],
                [1,0,0,0,2,1,0,0,0,1,2,0,0,0,0,0,0,0,0,1],
                [1,0,0,0,2,1,0,0,0,1,2,0,0,0,0,0,0,0,0,1],
                [1,0,0,0,2,1,0,0,0,1,2,0,0,0,0,0,0,0,0,1],
                [0,0,0,0,2,1,1,1,1,1,2,0,0,0,0,0,0,0,0,0],
                [0,0,0,0,2,0,0,0,0,0,2,0,0,0,0,0,0,0,0,0],
                [0,0,0,0,2,0,0,0,0,0,2,0,0,0,0,0,0,0,0,0],
                [1,0,0,0,2,1,1,1,1,1,2,0,0,0,0,0,0,1,1,1],
                [1,0,0,0,2,1,0,0,0,1,2,0,0,0,0,0,0,1,1,1],
                [1,1,1,1,1,1,1,1,1,1,1,1,1,1,1,1,1,1,1,1]
            ],
            "entityData":[
                {"eType":"enemyy", "X": 200, "Y": 80, "W":18, "H":11, "state": "idle_0", "ally": "False", "type":"met", "facingLeft":"True", "Motion":"None", "maxMotion":"None", "speed":[0,0.1], "jumpForce":0, "damage":5,"contactDamage":5,"HP":2,"imune":"None","weak":"None"},
                {"eType":"pickup", "X": 168, "Y": 80, "W":16, "H":12, "state": "idle_0", "ally": "True", "type":"big_ammo", "facingLeft":"False", "Motion":"None", "maxMotion":"None", "speed":[0,0.1], "jumpForce":0, "damage":1,"contactDamage":5,"HP":2,"imune":"None","weak":"None","A":10},
                {"eType":"pickup", "X": 216, "Y": 80, "W":16, "H":16, "state": "idle_0", "ally": "True", "type":"big_health", "facingLeft":"False", "Motion":"None", "maxMotion":"None", "speed":[0,0.1], "jumpForce":0, "damage":1,"contactDamage":5,"HP":2,"imune":"None","weak":"None","A":50},

                {"eType":"pickup", "X": 16, "Y": 80, "W":16, "H":12, "state": "idle_0", "ally": "False", "type":"big_neg_ammo", "facingLeft":"False", "Motion":"None", "maxMotion":"None", "speed":[0,0.1], "jumpForce":0, "damage":1,"contactDamage":5,"HP":2,"imune":"None","weak":"None","A":10},
                {"eType":"pickup", "X": 64, "Y": 80, "W":16, "H":16, "state": "idle_0", "ally": "False", "type":"big_neg_health", "facingLeft":"False", "Motion":"None", "maxMotion":"None", "speed":[0,0.1], "jumpForce":0, "damage":1,"contactDamage":5,"HP":2,"imune":"None","weak":"None","A":50}
            ]
        },
        "room2":{
            "exit":{
                "self":{
                    "to":"room2",
                    "changeNextBy":0
                },
                "left":{
                    "to":"room1",
                    "changeNextBy":0
                },
                "right":{
                    "to":"room3",
                    "changeNextBy":0
                },
                "top":{
                    "to":"",
                    "changeNextBy":0
                },
                "bottom":{
                    "to":"",
                    "changeNextBy":0
                }
            },
            "roomstate":0,
            "data":[
                [1,1,1,1,1,1,1,1,1,1,1,1,1,1,1,1,1,1,1,1],
                [1,0,0,0,0,0,0,0,0,0,0,0,0,0,0,0,0,0,0,1],
                [1,0,0,0,0,0,0,0,0,0,0,0,0,0,0,0,0,0,0,1],
                [1,0,0,0,0,0,0,0,0,0,0,0,0,0,0,0,0,0,0,1],
                [1,0,0,0,0,0,0,0,0,0,0,0,0,0,0,0,0,0,0,1],
                [1,0,0,0,0,0,0,0,0,0,0,0,0,0,0,0,0,0,0,1],
                [1,0,0,0,0,0,1,1,2,1,1,0,0,0,0,0,0,0,0,1],
                [1,0,0,0,0,0,0,0,2,0,0,0,0,0,0,0,0,0,0,1],
                [1,0,0,0,0,0,0,0,2,0,0,0,0,0,0,0,0,0,0,1],
                [1,0,0,0,0,0,0,0,2,0,0,0,0,0,1,2,1,0,0,1],
                [1,0,0,0,0,0,0,0,2,0,0,0,0,0,0,2,0,0,0,0],
                [0,0,0,0,0,0,0,0,2,0,0,0,0,0,0,2,0,0,0,0],
                [0,0,0,0,0,0,0,0,2,0,0,0,0,0,0,2,0,0,0,0],
                [0,0,0,0,0,0,0,0,2,0,0,0,0,0,0,0,0,1,1,1],
                [1,1,0,0,0,0,0,0,2,0,0,0,0,0,0,0,0,1,1,1],
                [1,1,0,0,0,0,0,0,2,0,0,0,0,0,0,0,0,1,1,1],
                [1,1,1,1,1,1,1,1,1,1,1,1,1,1,1,1,1,1,1,1]
            ],
            "entityData":[]
        },
        "room3":{
            "exit":{
                "self":{
                    "to":"room3",
                    "changeNextBy":0
                },
                "left":{
                    "to":"room2",
                    "changeNextBy":0
                },
                "right":{
                    "to":"",
                    "changeNextBy":0
                },
                "top":{
                    "to":"",
                    "changeNextBy":0
                },
                "bottom":{
                    "to":"",
                    "changeNextBy":0
                }
            },
            "roomstate":0,
            "data":[
                [1,1,1,1,1,1,1,1,1,1,1,1,1,1,1,1,1,1,1,1,1,1,1,1,1,1,1,1,1,1,1,1,1,1,1,1,1,1,1,1,1,1,1,1,1,1,1,1,1,1,1,1,1,1,1,1,1,1,1,1,1,1,1,1,1,1,1,1,1,1,1,1,1,1,1,1,1,1,1,1],
                [1,0,0,0,0,0,0,0,0,0,0,0,0,0,0,0,0,0,0,0,0,0,0,0,0,0,0,0,0,0,0,0,0,0,0,0,0,0,0,0,0,0,0,0,0,0,0,0,0,0,0,0,0,0,0,0,0,0,0,0,0,0,0,0,0,0,0,0,0,0,0,0,0,0,0,0,0,0,0,1],
                [1,0,0,0,0,0,0,0,0,0,0,0,0,0,0,0,0,0,0,0,0,0,0,0,0,0,0,0,0,0,0,0,0,0,0,0,0,0,0,0,0,0,0,0,0,0,0,0,0,0,0,0,0,0,0,0,0,0,0,0,0,0,0,0,0,0,0,0,0,0,0,0,0,0,0,0,0,0,0,1],
                [1,0,0,0,0,0,0,0,0,0,0,0,0,0,0,0,0,0,0,0,0,0,0,0,0,0,0,0,0,0,0,0,0,0,0,0,0,0,0,0,0,0,0,0,0,0,0,0,0,0,0,0,0,0,0,0,0,0,0,0,0,0,0,0,0,0,0,0,0,0,0,0,0,0,0,0,0,0,0,1],
                [1,0,0,0,0,0,0,0,0,0,0,0,0,0,0,0,0,0,0,0,0,0,0,0,0,0,0,0,0,0,0,0,0,0,0,0,0,0,0,0,0,0,0,0,0,0,0,0,0,0,0,0,0,0,0,0,0,0,0,0,0,0,0,0,0,0,0,0,0,0,0,0,0,0,0,0,0,0,0,1],
                [1,0,0,0,0,0,0,0,0,0,0,0,0,0,0,0,0,0,0,0,0,0,0,0,0,0,0,0,0,0,0,0,0,0,0,0,0,0,0,0,0,0,0,0,0,0,0,0,0,0,0,0,0,0,0,0,0,0,0,0,0,0,0,0,0,0,0,1,2,1,2,1,0,0,0,0,0,0,0,1],
                [1,0,0,0,0,0,0,0,0,0,0,0,0,0,0,0,0,0,0,0,0,0,0,0,0,0,0,0,0,0,0,0,1,1,0,0,0,0,0,0,0,0,0,0,0,0,0,0,0,0,0,0,0,0,0,0,0,0,0,0,0,0,0,0,0,0,0,0,2,1,2,0,0,0,0,0,0,0,0,1],
                [0,0,0,0,0,0,0,0,0,0,0,0,0,0,0,0,0,0,0,0,0,0,0,0,0,0,0,0,0,0,0,0,1,1,0,0,0,0,0,0,0,0,0,0,0,0,0,0,0,0,0,0,0,0,0,0,0,0,0,0,0,0,0,0,0,0,0,0,2,1,2,0,0,0,0,0,0,0,0,1],
                [0,0,0,0,0,0,0,0,0,0,0,0,0,0,0,0,0,0,0,0,0,0,0,0,0,0,0,0,0,0,0,0,1,1,0,0,0,0,0,0,0,0,0,0,0,0,0,0,0,0,0,0,0,0,0,0,0,0,0,0,0,0,0,0,0,0,0,0,2,1,2,0,0,0,0,0,0,0,0,1],
                [0,0,0,0,0,0,0,0,0,0,0,0,0,0,0,0,0,1,1,1,1,1,1,0,0,0,0,0,0,0,0,0,0,0,0,0,0,0,0,0,0,0,0,0,0,0,0,0,0,0,0,0,0,0,0,0,0,0,0,0,0,0,0,0,0,0,0,0,2,1,1,0,0,0,0,0,0,0,0,1],
                [1,1,1,1,0,0,0,0,0,0,0,0,0,0,0,0,0,0,0,0,0,0,0,0,0,0,0,0,0,0,0,0,0,0,0,0,0,0,0,0,0,0,0,0,0,0,0,0,0,0,0,0,0,0,0,0,0,0,0,0,0,0,0,0,0,0,0,0,2,1,1,0,0,0,0,0,0,0,0,1],
                [1,0,0,0,0,0,0,0,0,0,0,1,1,0,0,0,0,0,0,0,0,0,0,0,0,0,0,0,0,0,0,0,1,1,0,0,0,0,0,0,0,0,0,0,0,0,0,0,1,1,1,1,0,0,0,0,0,0,0,0,0,0,0,0,0,0,0,0,2,1,1,0,0,0,0,0,0,0,0,1],
                [1,0,0,0,0,0,0,0,0,1,0,1,1,1,1,1,0,0,0,0,0,0,0,0,0,0,0,0,0,0,0,0,1,1,0,0,0,0,0,0,0,0,0,0,0,0,0,1,1,1,1,1,1,1,1,0,0,0,0,0,0,0,0,0,0,0,0,0,2,1,1,1,0,1,1,0,0,0,0,1],
                [1,1,1,1,1,1,1,1,1,1,1,1,1,1,1,1,1,1,1,1,1,1,1,1,1,1,1,1,1,1,1,1,1,1,1,1,1,1,1,1,1,1,1,1,1,1,1,1,1,1,1,1,1,1,1,1,1,1,1,1,1,1,1,1,1,1,1,1,1,1,1,1,1,1,1,1,1,1,1,1]
            ],
            "entityData":[
                {"eType":"enemy", "X": 400, "Y": 80, "W":26, "H":24, "state": "idle_0", "ally": "False", "type":"sniper_joe", "facingLeft":"True", "Motion":"None", "maxMotion":[10,10,10], "speed":[0,0.2], "jumpForce":6, "damage":5,"contactDamage":10,"HP":10,"imune":"None","weak":"None"}
            ]
        },
        "room4":{
            "exit":{
                "self":{
                    "to":"room4",
                    "changeNextBy":0
                },
                "left":{
                    "to":"",
                    "changeNextBy":0
                },
                "right":{
                    "to":"room1",
                    "changeNextBy":0
                },
                "top":{
                    "to":"",
                    "changeNextBy":0
                },
                "bottom":{
                    "to":"pit",
                    "changeNextBy":0
                }
            },
            "roomstate":0,
            "data":[
                [1,1,1,1,1,1,1,1,1,1,1,1,1,1,1,1,1,1,1,1],
                [1,0,0,0,0,0,0,0,0,0,0,0,0,0,0,0,0,0,0,1],
                [1,0,0,0,0,0,0,0,0,0,0,0,0,0,0,0,0,0,0,1],
                [1,0,0,0,0,0,0,0,0,0,0,0,0,0,0,0,0,0,0,1],
                [1,0,0,0,0,0,0,0,0,0,0,0,0,0,0,0,0,0,0,1],
                [1,0,0,0,0,0,0,0,0,0,0,0,0,0,0,0,0,0,0,1],
                [1,0,0,0,0,0,0,3,3,1,1,0,0,0,0,1,1,3,3,1],
                [1,0,0,0,0,0,0,0,0,0,0,0,0,0,1,0,0,0,0,1],
                [1,0,0,0,0,0,0,0,0,0,0,0,0,1,0,0,0,0,0,1],
                [1,0,0,0,0,0,0,0,0,0,0,0,1,0,0,0,0,0,0,0],
                [1,0,0,0,0,0,0,0,0,1,2,1,0,0,0,0,0,0,0,0],
                [1,0,0,0,0,0,0,0,0,0,2,0,0,0,0,0,0,0,0,0],
                [1,0,0,0,0,0,0,0,0,0,2,0,0,0,0,0,0,1,1,1],
                [1,0,0,0,0,0,0,0,0,0,2,0,0,0,0,0,0,1,1,1],
                [1,1,1,1,1,0,0,0,1,1,1,1,1,1,1,1,1,1,1,1]
            ],
            "entityData":[]
        }
    },
    "tiles":{
        "0":{
            "path":"empty",
            "solidType":0
        },
        "1":{
            "path":"brick",
            "solidType":1
        },
        "2":{
            "path":"ladder",
            "solidType":2
        },
        "3":{
            "path":"spike",
            "solidType":3
        }
    }
}